{
  "rows": 8,
  "cols": 8,
  "start_x": 190,
  "start_y": 400,
  "spacing_x": 20,
  "spacing_y": 20,
  "blocks": [
	[1, 0, 1, 0, 1, 0, 1, 0],
	[0, 1, 0, 1, 0, 1, 0, 1],
	[1, 0, 1, 0, 1, 0, 1, 0],
	[0, 1, 0, 1, 0, 1, 0, 1],
	[1, 0, 1, 0, 1, 0, 1, 0],
	[0, 1, 0, 1, 0, 1, 0, 1],
	[1, 0, 1, 0, 1, 0, 1, 0],
	[0, 1, 0, 1, 0, 1, 0, 1]
  ]
}
