{
  "rows": 12,
  "cols": 12,
  "start_x": 150,
  "start_y": 360,
  "spacing_x": 20,
  "spacing_y": 20,
  "blocks": [
	[1, 1, 1, 1, 1, 1, 1, 1, 1, 1, 1, 1],
	[1, 0, 0, 0, 0, 0, 0, 0, 0, 0, 0, 1],
	[1, 0, 1, 1, 1, 1, 1, 1, 1, 1, 0, 1],
	[1, 0, 0, 0, 0, 0, 0, 0, 0, 1, 0, 1],
	[1, 1, 1, 1, 1, 1, 1, 1, 0, 1, 0, 1],
	[1, 0, 0, 0, 0, 0, 0, 1, 0, 1, 0, 1],
	[1, 0, 1, 1, 1, 1, 0, 1, 0, 1, 0, 1],
	[1, 0, 1, 0, 0, 0, 0, 1, 0, 1, 0, 1],
	[1, 0, 1, 1, 1, 1, 1, 1, 0, 1, 0, 1],
	[1, 0, 0, 0, 0, 0, 0, 0, 0, 1, 0, 1],
	[1, 1, 1, 1, 1, 1, 1, 1, 1, 1, 0, 1],
	[1, 1, 1, 1, 1, 1, 1, 1, 1, 1, 1, 1]
  ]
}
