{
  "rows": 10,
  "cols": 10,
  "start_x": 170,
  "start_y": 380,
  "spacing_x": 20,
  "spacing_y": 20,
  "blocks": [
	[0, 0, 1, 1, 1, 1, 1, 1, 0, 0],
	[0, 1, 0, 0, 0, 0, 0, 0, 1, 0],
	[1, 0, 0, 0, 0, 0, 0, 0, 0, 1],
	[1, 0, 0, 0, 0, 0, 0, 0, 0, 1],
	[1, 0, 0, 0, 0, 0, 0, 0, 0, 1],
	[1, 0, 0, 0, 0, 0, 0, 0, 0, 1],
	[1, 0, 0, 0, 0, 0, 0, 0, 0, 1],
	[1, 0, 0, 0, 0, 0, 0, 0, 0, 1],
	[0, 1, 0, 0, 0, 0, 0, 0, 1, 0],
	[0, 0, 1, 1, 1, 1, 1, 1, 0, 0]
  ]
}
