{
  "rows": 15,
  "cols": 15,
  "start_x": 120,
  "start_y": 330,
  "spacing_x": 20,
  "spacing_y": 20,
  "blocks": [
	[1, 1, 1, 1, 1, 0, 0, 0, 0, 0, 1, 1, 1, 1, 1],
	[1, 0, 0, 0, 1, 0, 0, 0, 0, 0, 1, 0, 0, 0, 1],
	[1, 0, 1, 1, 1, 1, 1, 1, 1, 1, 1, 1, 1, 0, 1],
	[1, 0, 1, 0, 0, 0, 0, 0, 0, 0, 0, 0, 1, 0, 1],
	[1, 0, 1, 0, 1, 1, 1, 1, 1, 1, 1, 0, 1, 0, 1],
	[0, 0, 1, 0, 1, 0, 0, 0, 0, 0, 1, 0, 1, 0, 0],
	[0, 0, 1, 0, 1, 0, 1, 1, 1, 0, 1, 0, 1, 0, 0],
	[0, 0, 1, 0, 1, 0, 1, 0, 1, 0, 1, 0, 1, 0, 0],
	[0, 0, 1, 0, 1, 0, 1, 1, 1, 0, 1, 0, 1, 0, 0],
	[0, 0, 1, 0, 1, 0, 0, 0, 0, 0, 1, 0, 1, 0, 0],
	[1, 0, 1, 0, 1, 1, 1, 1, 1, 1, 1, 0, 1, 0, 1],
	[1, 0, 1, 0, 0, 0, 0, 0, 0, 0, 0, 0, 1, 0, 1],
	[1, 0, 1, 1, 1, 1, 1, 1, 1, 1, 1, 1, 1, 0, 1],
	[1, 0, 0, 0, 1, 0, 0, 0, 0, 0, 1, 0, 0, 0, 1],
	[1, 1, 1, 1, 1, 0, 0, 0, 0, 0, 1, 1, 1, 1, 1]
  ]
}
